questioning	A1
expressing self clearly and	S4
seek develop and secure new opportunities	S4
measure monitor and review performance of key accounts	S4
ensuring budgets and forecasts are met	S4
identify and monitor key performance and financial indicators	A1
maintain and monitor service expectations of existing and key accounts	S3
support external sales force	A1
management of business	A1
select appropriate carrier	A1
maximise freight profits	S4
manage your own time	A1
integrate and co-ordinate new business	S1
arrange regular meetings	S4
submit financial reports	S4
CIMA	A1
care deeply	A1
ever-changing environment	S4
excel	A1
shape the world of iot	A1
advocate quality	A1
verify	A1
validate	A1
analyze	A1
lower risks	S1
automate tests	S1
build great products	S4
shape the features	A1
cloud-based microservices	S1
audio/video pipelines	S1
machine learning	S1
mobile applications	A1
critical thinker	A1
user experience	A1
quality	A1
software testing	S4
curiosity	A1
resourcefulness	A1
find problems	A1
provide creative solutions	S4
software testing techniques	S4
advocate for quality in decision making	A1
tinkerer	A1
create your own apps and robots	S4
working closely with developers	S4
diligent with documenting your test plans test cases bug reports	S1
coding	S4
python	A1
java	S1
javascript	L1
Golang	S4
selenium	A1
TestCafe	S1
web	S4
api	S4
backend	A1
integration	S1
performance/load/stress	A1
security testing	S4
continuous integration	A1
continuous delivery and/or deployment	A1
jenkins	S1
CircleCI	S3
linux	A1
Docker	A1
Kubernetes	S4
web services	K01
networking	S4
distributed systems	A1
cloud services	S1
GraphQL	A1
driving?	S4
fast-paced team environment?	S4
upholding a positive brand image	A1
providing excellent customer service	A1
managing cash and card transactions	S4
delivering products safely and securely	S4
avoiding unnecessary risks	S3
safety and security procedures	S4
uk or eu driving license	S1
own car	A1
local area	A1
fast-paced environment	A1
customer service	A1
quality	A1
driving!	S4
food hygiene	A1
store cleanliness	S4
keen eye for detail	A1
day to day running of kitchen ordering and installs	S4
work closely with our installation team	A1
deliver projects efficiently	A1
maintain an impeccable level of customer service	A1
joinery	A1
kitchen industry!	S1
email	S4
organisational skills	S1
self-motivated	A1
working on their own initiative	A1
communicator	A1
kitchen industry	A1
computers	S1
attention to detail	A1
building and maintaining strong relationships	S4
multi-task	S1
deliver against deadlines	A1
valid uk driving license	A1
communication skills	S1
kitchen industry	A1
valid uk driving licence	A1
a-level	S4
support the bakery management team	S4
support the teams	S4
go above and beyond for our customers	S4
positive	A1
energetic	A1
engaging with people	S4
communications skills	S1
talented	A1
fun	S1
ambitious	A1
provide first line support to our team of colleagues	S4
reporting directly to the head of team experience	S4
overseeing hr administration	S4
maintaining hr records	S4
compiling hr data	A1
running reports	S4
managing hr processes	S4
hr best practices	A1
processes	S4
policies	A1
employment law	A1
organisation	A1
attention to detail	A1
positive	A1
professional	A1
communication	S1
literacy	S1
numeracy	A1
it skills	S1
willingness to develop	A1
line management	A1
level 5 cipd	S1
Kronos	A1
maximising sales	S4
building a highly engaged and high performing team	S4
leading from the front	A1
hands-on approach	A1
inspire your team	S4
inject fun into the work place	S4
create a truly amazing place to work	A1
delivers an exceptional standard of customer service	A1
pet knowledge	A1
deliver the highest standards of pet care	A1
ensure that the welfare of pets is a top priority	A1
promoting responsible pet ownership	S3
motivating training and developing your team	S4
running a store	S4
achieving and exceeding key store targets	S4
communicate effectively to your team	S1
take full responsibility for the store	A1
involved in absolutely everything in your store	A1
recruitment	S1
stock control	S4
store standards	S4
retail	A1
pets!	S4
supervisory/management	A1
hands-on approach	A1
delivering high standards!	S4
people person	A1
team player	A1
communication	S1
engage and inspire a team	S4
proactive	A1
customer focused	A1
recording of events and service failures	S4
chasing and completion of calls	S4
production of work request failures	A1
liaising with internal team and external contractors	S4
maintenance of records of live and paid works	A1
kpi's	S4
SLA's	A1
raising purchase orders	A1
completion of worksheet upload spreadsheet	A1
cafm system administration	A1
assisting the helpdesk manager	S4
general office administration duties	A1
reporting	S4
provide minutes of meetings	S4
contract administration	A1
ensure the helpdesk operates professionally	S4
manage the lines of communication	S1
achieve a high degree of customer and supplier satisfaction	S1
achieving key performance indicators ( kpis	S1
customer service	A1
system knowledge	A1
operate a helpdesk function across multiple sites	S4
accurately record details of the caller problem and severity	S4
ensure that the service centre manager is aware of situations which could develop into issues	S4
work within and to processes and procedures	A1
respond quickly and efficiently to all requests	A1
attention to detail	A1
obtaining and inputting information	S4
clear and professional telephone manner	A1
achieve a high degree of customer and supplier satisfaction	S1
applying logic and common sense	A1
ensuring that identified criteria are escalated	A1
scheduling ppm remedial and reactive work	S1
jeopardy management	A1
escalation of planned and responsive works	A1
monitor and optimise the utilisation of engineer activities	S4
scheduling of works	A1
raising purchase orders	A1
run reports	S4
show outstanding work orders	S4
attend training and coaching sessions	S4
identify any potential areas of improvement	A1
flexible	A1
adaptable	A1
highlight any training needs and development	S1
operating a facilities management helpdesk	S4
call centre service	S4
developing productive working relationships	S4
qfm helpdesk system	A1
computer hardware	A1
peripherals	A1
applications	A1
networks	S1
shared files and folders	S4
report creation	S4
keyboard skills	S1
focusing on client & customer	S4
delivering stretched results	S4
act collaboratively	A1
intellectual agility	A1
willingness to learn	S1
computer databases	A1
nvq level 2 or 3	A1
customer service	A1
call handling	A1
working with and developing kpi’s and measurement information	S4
rsa level i keyboard skills	S1
european computer driving licence ( ecdl ) level i	S1
microsoft word	A1
microsoft excel	A1
level 2 & 3 nursery	S1
providing care and educational support	S4
pms	S1
reservation systems	A1
customer service?	A1
organised analytical approach	S1
numerical skills	S1
pms	S1
reservation systems	A1
timekeeping	S4
work calmly in a high-pressure environment	S1
english	L1
making reservations	S4
ensuring that all enquiries receive a prompt response	S4
all correspondence is accurately filed	A1
log failures	A1
convert a booking	A1
monitor non-arrivals and late cancellations	S1
run daily arrival checks	S4
ensure all reservations are correct	S4
work with others	A1
improve our customer service	A1
cover reception	A1
monitoring and recording key data	S4
keeping the pms up-to-date	A1
ensure that market segmentation rates and guest information are accurately recorded	S4
helping the hotel to achieve its financial targets	S4
upsell	A1
escalate/communicate about any new sales leads	S1
contribute to pricing decisions	S4
highlighting if availability is changing	S4
rate strategies should be reviewed	S4
pms	S1
reservation systems	A1
organised	K01
analytical	A1
customer service	A1
commercial awareness	S1
corporate tax	A1
personal tax	A1
vat	S1
ACCA/ACA/ATT	S4
cta	S4
supporting and training the more junior member of staff	S4
manging	S4
supervising	S4
coaching	S4
mentoring	S4
work with a varied portfolio	A1
provide compliance and advisory services	A1
support clients	S4
services in corporation tax and personal tax	S1
work in a varied capacity	A1
confident	A1
professional	A1
ambitious	A1
tax planning	S4
advisory work	A1
tax computations and reviews	S1
capital gains tax	A1
trusts	A1
inheritance tax/wills	A1
property tax	A1
corporate tax planning	S1
mergers & acquisitions	A1
restructuring	S3
investments	A1
dealing with a variety of high net worth individuals partnerships directors tax omb	S4
manage the team	S1
planning and reviewing work in progress	S4
supporting the directors	S4
providing direction to the team	S4
lead and grow the department	S4
business development	S1
selling services	S1
CIMA	A1
help residents enjoy each day	S4
assist with daily living	A1
providing support and companionship	S4
dedication	S1
compassion	A1
supporting residents with their food and drink	S4
following care plans	S1
caring for older people	S4
can-do approach	A1
communication skills	S1
empathy	A1
warm-hearted approach	S1
compassion	A1
deliver the highest standard of care and support	S4
drive expansion	S4
exceed monthly / quarterly sales targets	A1
driving new opportunities	S4
exceed monthly / quarterly sales targets	A1
driving new opportunities	S4
analyse your industry territory	A1
identify prioritise and segment accounts	K03
collaborating	K09
create demand	S4
cold calling	S4
email / social campaigns	A1
supporting other business development activities	S4
engage your extended team	A1
engage with prospect organisations	S4
strategic value-based selling	S1
business case definition	S1
return on investment analysis	A1
references	S4
analyst data	A1
engage with customer cios and cfos	A1
converse with senior technologists	S4
generate short term results	A1
maintaining a long term perspective	A1
maximize overall revenue generation	A1
provide accurate monthly forecasting and revenue delivery	S4
build and maintain a territory pipeline of business	A1
selling enterprise software	A1
PaaS	S4
IaaS	S1
saas	S1
net direct new business sales	S4
consistent delivery against targets	A1
strong customer care	A1
helping to ensure customer success	S4
credibility	A1
building strong relationships internally and with the customer	S1
selling industry-specific use cases / technologies	A1
CPG	A1
manufacturing	S4
services	S4
iPaaS	S1
api management	A1
automation	S3
bpm	S4
deliver key business outcomes	S4
bachelor’s degree	S1
full driving license	S4
internal framing work	S1
finishing work	A1
skirtings	S4
facings	K01
cscs card	S1
carpentry	A1
CSCS	S1
electro/mechanical assembly	A1
hand assembly	A1
wiring electronic sub-assemblies	S4
mechanical assembly	A1
working to customer specifications	A1
can do attitude	A1
driving	S4
strategic planning & governance	S4
strategic planning	S4
performance reporting	S4
strategic planning	S4
corporate performance	S1
manage the strategic planning and corporate performance reporting functions	S4
manage the strategic and operational planning process	A1
support senior colleagues	S4
completing plans	S1
provide specialist advice	A1
guidance	S1
support to managers staff and the public	S4
strategic planning	S4
corporate performance	S1
conduct stakeholder consultation/engagement	S4
engage with internal and external groups and networks	S4
development or expansion of good practice	A1
strategic planning	S4
corporate performance	S1
coordinate the preparation of an annual report	S4
ensure the annual report complies with the government financial reporting manual ( frem	A1
government financial reporting manual ( frem	A1
analytical decision making	A1
communication skills	S1
maintain positive relationships	S1
seek information and co-operation	S4
conduct trend analysis on complex data sets	A1
working with stakeholders	S4
inform of any discrepancies variances and trends	A1
scqf level 9	A1
technology	A1
project manage	A1
bridge the gap	S4
liaising with many stake holders	K03
influencing and negotiation skills	S1
prince2 practitioner qualification	A1
msp qualification	A1
project management	A1
change management	S4
benefit realisation	A1
workforce redesign	A1
energetic	A1
work independently as well as in a team	A1
persistent	A1
sales	S4
B2B	K01
concept sales	A1
business	S1
english	L1
french	A1
german	S1
java	S1
working in the web layer	S4
working as a key member of an agile team	A1
frequent delivery	A1
end-to-end application ownership	A1
contributing to a cross functional agile team	S4
elaboration development and testing of user stories	S4
sprint planning	S4
backlog grooming	A1
task estimation	A1
development and modification of frameworks common components and business components	A1
development of unit tests	S4
contribution to the creation of automation in higher levels of the test pyramid	S4
refactoring code	A1
contribution to code quality improvements	K03
development standards	S4
best practices	S4
software development	A1
review of colleagues code	S4
progressive development behaviours	A1
maximizing collaboration	A1
knowledge sharing	A1
effective pairing	A1
creation of pocs / spike development	S4
involvement in technology evaluation	A1
work and communicate across geographical and cultural borders	S1
build a strong professional network	A1
participation in the elaboration of user stories	A1
agree stories are sufficiently described	A1
quality design and implementation	S4
ensuring builds are kept green	A1
code management strategy ( branching ) is closely	S1
raising capability and standards	S4
pairing on tasks	S4
peer review of team members code	A1
constructive feedback for improvement	S1
proactive contribution to continual improvements	S1
active participation in retrospectives	A1
engagement with cross team bestpractice	S1
support product owner	A1
identify and manage risks debt issues and opportunities	S3
support the recruitment activities	S4
technical support	A1
technical support	A1
implementation skills	S1
java	S1
SpringBoot	A1
unit testing	S4
development	S1
agile	A1
integration of testing into development workflow	S4
test frameworks build tooling	A1
maven)	S1
work in ui	A1
continual delivery pipeline tools	S1
jenkins	S1
ansible	A1
communication skills	S1
articulate clearly to technical team members	A1
work with product owners	S4
collaborative	A1
critical reasoning	A1
problem solving	A1
agile software development	S1
xp	K01
BDD	K01
TDD	A1
fast turnaround development	S4
continuous delivery	A1
service orientated	A1
microservice architecture	K01
shared-nothing architecture	A1
domain driven design	A1
bounded context	A1
high volume transactional systems	S3
api gateway	A1
Akana	A1
coherent software architecture and design	A1
message or event based architectures	S4
eventual consistency concepts	A1
contributor to open source projects	S4
mechanical understanding	S4
automation	S3
process optimization	A1
support and problem-solving	S4
decanters	A1
high-speed separators	S4
putting put the customer first	S4
preventive maintenance of supplied equipment and machines	A1
repair and service according to customer requirements	S4
support to customers	S4
general technical support	A1
adjustments to equipment and machines	A1
start-up and commissioning of machinery	S4
process plants on board vessels	S4
training of the crew	S4
optimization of plant and equipment	A1
decanters	A1
high-speed separators	S4
PureBilge	A1
FWG	A1
pure	A1
marine business	A1
sailing	A1
mechanical understanding	S4
automation	S3
control systems	A1
microsoft office	A1
danish	L1
english	L1
developing our new data backbone	S4
inspiring the stakeholders	S4
advanced analytics	A1
artificial intelligence	A1
extracting insights and value from data	A1
applying domain expertise	A1
ensure data collection procedures	A1
building analytic systems	A1
operationalise data mining and analysis into business applications	A1
maintain the productionised models	S4
quantitative or data-heavy functions	A1
c#	S1
python	A1
java	S1
open source data ingestion tools	A1
nifi	A1
cloud platforms	S1
container technology tools	S1
analytics engines	S1
spark	S1
Databricks	S4
data visualisation tools	S1
cloud platforms	S1
machine learning	S1
algorithms	S1
willingness to learn	S1
criminal record certificate	A1
criminal record certificate	A1
criminal record certificate	A1
registering and controlling goods	S4
picking and packing	S4
preparing pallets	S4
loading and unloading lorries	S4
operating a forklift	A1
forklift license	A1
independently	A1
proactively	A1
set high standards	S4
flexible	A1
helpful	A1
developing and applying new optical microscopy techniques	S4
intestine	A1
biopharmaceuticals	A1
reinvent our research strategies	S4
constructing a 'light sheet' fluorescence microscope	A1
live-sample imaging	S1
3d printed organoids	A1
pursue a deeper understanding	A1
implementing one of the worlds most advanced optical microscopes	A1
use the microscope	A1
capture how fluorescently labelled biopharmaceuticals travel through the intestinal barrier	S4
optimizing microscope hardware and software	A1
provide the best images	S4
drive hardware/software development	S4
document present and publish scientific findings	S4
contribute to the enjoyable and collaborative work environment	S1
master's degree	S4
work independently	A1
prioritize tasks	S4
plan and execute complex hardware implementation	A1
interface optics	A1
electronics	A1
software	A1
work constructively in a team	S1
analyse	S4
contribute	S4
solve biological/mathematical challenges	A1
use software for instrument control	S1
labview	A1
use software for data simulation	S1
basic image analysis	A1
matlab	A1
use software for basic mechanical design	A1
SOLIDWORKS	A1
communicate professionally	A1
english	L1
present insights progress and bottlenecks	S4
european code of conduct for research integrity	S1
software/hardware development	S1
fundamental biology/physiology	A1
bsc/msc diploma	S1
research	L1
teaching	S4
marketingin	A1
business	S1
development	S1
active engagement	A1
strengthen the relationship	A1
initiate and participate in external funding	A1
sustained record of research publications	K09
research management	S4
teaching	S4
provide dynamic leadership	A1
teaching	S4
research dissemination	S4
working with business and society	S1
undertaking research	A1
teaching practice	S1
dissemination	S4
business research	S1
research management	S4
initiation of research projects	S4
supervision of ph.d	S4
international research co-operation	A1
journal editorship	A1
reviewing for academic journals	S4
academic development	S1
marketing	S1
research-based teaching	S1
supervision	S4
examination	A1
teaching on business research	S4
course and program development	S4
promotion	A1
participation in and possibly initiation of externally funded research projects	S3
contribution to the administrative responsibilities	A1
dissemination of research findings	S4
participation in the departments regular research activities	A1
engagement in and contribution to academic citizenship activities	S4
participate actively in the research and teaching activities	A1
maintain and establish broad links	A1
record of research	A1
teaching	S4
research management	S4
research	L1
teaching	S4
business research	S1
provide dynamic leadership	A1
development of research	S4
teaching	S4
research dissemination	S4
working with business and society	S1
achieving ) research grants	S1
pedagogical qualifications	A1
development and innovation in the pedagogical area	S4
english	L1
teaching qualifications	S4
teaching evaluations	S4
love being outdoors	S4
create an entertaining & memorable tour	A1
share your knowledge?	A1
responsible and professional work ethic?	A1
providing fun informative and engaging tours	S4
know all information provided	A1
run tours on time	S4
provide extensive information about the city	S4
answering customer questions	A1
show independent thinking	A1
professonal approach	S1
leadership	S1
assiting with teambuilding excercises	S4
leading	S1
meticulous	A1
detail-oriented	A1
ensure the shop is tidy and clean	A1
dusting	S4
vacuuming	S4
set up for your customers	S4
independent work approach	A1
street-marketing	S1
street-marketing	S1
approaching people	S4
confident	A1
engaging	S4
english	L1
german	S1
danish	L1
lively	A1
fun	S1
public speaking	S4
engage an audience	S1
responsible	A1
dutiful	A1
mature	S1
demonstrate leadership abilities	S1
service-minded	A1
providing a first-class experience	S4
perform at your best ability	A1
high-school diploma	S1
bachelor/post-graduate degree	S4
danish	L1
english	L1
service-industry	A1
tourism	A1
social media marketing	S1
sales	S4
Segways	A1
first-aid skills	S1
stamina	A1
love for being outdoors	S4
supply chain	A1
manage challenges	A1
business acumen	S1
planning skills	S1
collaborating	K09
ensure reliable supply	A1
operating in a structured formal monthly sales and operations planning process	S4
sales and operations planning process	S4
maximize product availability	A1
standardized global processes	S1
sap	A1
optimize supply and inventory plans	A1
lead supply scenario analysis	S1
monitor supply and capacity performance	A1
coordinate supply and capacity bottleneck management	A1
support the supply risk management process	S4
respond to ad hoc requests	A1
establish and develop a close collaboration	A1
planning	S4
masters degree	S4
business	S1
engineering	S4
supply chain management	S1
supply chain	A1
sap apo	A1
providing ideas and input for optimization	S4
handle hands-on planning tasks	A1
complex coordination	A1
overview	A1
sense of detail	A1
open-minded	A1
establish collaborative relations to people	S1
tailor your communication to your audience	S1
make people prioritize your agenda	S4
advanced electron microscopy	A1
environmental catalysis	A1
nanomaterials	A1
selective catalytic reduction ( scr ) of nox	S1
undertake atomic-scale studies	S1
situ transmission electron microscopy	A1
characterization tools	S1
surface science techniques	A1
catalyst testing	S4
synthesis	A1
develop an understanding of the catalytic performances	S4
target new designs of catalyst materials	A1
improving nox emission control	S1
experimental research	S4
scr catalysts	A1
application of s/tem and eels for atomic-resolution and in situ studies	S1
develop our atomic-scale model	A1
scr	S4
scr catalysis	A1
publishing in high-profile journals	S4
committed	A1
flexible	A1
innovative mind-set	A1
new ideas	A1
ready to face new challenges	A1
take responsibility	A1
execute and communicate complex research goals	S4
enthusiastic	A1
catalysis sciences	A1
Ph.D	A1
physics	A1
chemistry	A1
high-resolution ( scanning ) transmission electron microscopy ( s/tem	A1
heterogeneous catalysts	A1
solid-state nanomaterials	A1
audio engineering	S4
acoustic design	A1
algorithm trimming	K09
sound quality evaluation	A1
passion	A1
creativity	S4
work on new algorithm concepts	S1
directionality/beam-forming	A1
trimming and verification of various audio algorithms	S4
audio engineering	S4
msc	S1
outgoing	S4
getting things to move forward	S1
inspires your colleagues	S4
dealing with many stakeholders	S4
setting a direction	S4
english	L1
audio engineering	S4
algorithm concepting	S1
directionality	A1
beam-forming	S4
matlab	A1
python	A1
trimming of various audio algorithms	S1
noise reduction systems	A1
eq	A1
compressors	A1
objective and subjective sound quality evaluation	A1
measurement systems for audio evaluation	S1
soundcheck	A1
head acoustics acqua audio analyzers	S1
communicating technical issues	S1
research the market	A1
take initial contact to potential clients	S4
carry out market research of potential clients	S4
establish initial contact to potential clients	A1
translate sales material	S1
english	L1
italian	A1
italian	A1
english	L1
tele marketing	S4
proactive on the phone	S4
independent	A1
positive	A1
proactive	A1
danish	L1
working in a sales department	S4
leading technology strategy roadmaps and transformation plans	S4
communication	S1
integration	S1
PLM/PDM	S1
manufacturing execution	S4
product quality systems ( qsys	A1
global erp ( sap ) platforms	S1
dynamic	A1
personal motivation	A1
drive	A1
approach complex tasks	S1
open mind	A1
focus	S1
providing the best solution	A1
structured	S1
analytic	A1
lead the technology roadmap	S4
participate actively in strategic projects	A1
PLM	S1
main interface between plm data and systems governance organizations	A1
lead and coach a team	S4
PLM	S1
model and control enterprise plm architecture ( data and systems	A1
TOGAF	S4
asses value propositions of project proposals	A1
Teamcenter	S1
PLM	S1
how systems interact with erp	S1
manufacturing execution systems	S4
PLM	S1
erp systems	A1
capturing requirements from large organizations	S4
architecting value creating solutions for the business	S4
enabling the software to create value	A1
processes	S4
lifecycles	S1
wind turbine	A1
communicate on all levels	S4
persuasive communicator	A1
english	L1
teaching	S4
research	L1
basic and applied nutrition of ruminants	S3
dairy cattle	S1
dairy production	A1
data modelling	S1
evaluation of feed quality and feed intake in dairy cattle	S4
nordic feed evaluation system	S1
NorFor	A1
dairymanagement system	A1
feed evaluation	S4
digestive processes	A1
intermediary metabolism	A1
impact of nutrition and feeding management	S4
animal health	S4
product quality	A1
research	L1
publication/academic dissemination	S1
research-based teaching	S1
examination	A1
sharing knowledge with society	S4
phd degree	K01
research	L1
teaching	S4
enterprising	K01
interpersonal skills	S1
information technology	A1
java	S1
algorithm	K09
database	A1
multithreading	K01
concurrency	A1
solve technical challenges	A1
deliver high quality code	A1
build and ship new features	S4
write high quality testable and efficient code	A1
promote new ideas	A1
take active part in features discussions and roadmap prioritisation	A1
integrate cutting edge research and technologies	S4
work closely with our customers and other teams	A1
developing production level software	S4
designing multi-threaded systems and algorithms	S4
system design	A1
data structures	S4
algorithms	S1
java	S1
troubleshooting	A1
performance profiling	S4
optimisation	A1
development methodologies	A1
care about code quality	A1
communication skills	S1
sense of humor!	A1
eCommerce	S1
price comparison	A1
online portal	A1
.net	A1
agile	A1
rest	K02
microservices	S1
eCommerce	S1
price comparison	A1
online portal	A1
.net	A1
agile	A1
rest	K02
microservices	S1
development test and deployment of new components	S4
transition	S4
re-engineering	S4
design	K02
extension	S1
continuous integration	A1
continuous deployment	A1
.net	A1
micro services	A1
development and implementation of rest api's	S4
web and/or e-commerce	S1
agile method practice	S1
english	L1
german	S1
data science	A1
it security	A1
software development / engineering	S4
java	S1
rest	K02
cloud	A1
spring	S1
design-patterns	A1
data science	A1
it security	A1
software development / engineering	S4
java	S1
rest	K02
cloud	A1
spring	S1
design-patterns	A1
enthusiasm	A1
professional attitude	A1
work together closely with product owners and colleagues	S4
develop an in-depth understanding of the domains and the requirements	S4
happy to share your valuable insights	S1
offer them professional advice	A1
share your knowledge	A1
advise individual colleagues	A1
software development	A1
agile project team	S1
java stack frameworks	A1
quality	A1
testing at various levels in an agile environment	S4
test automation	S3
clear easy-to-maintain code	A1
latest technologies	A1
back end development	A1
databases	S1
cloud computing	S4
restful api	A1
big data	A1
devops	A1
build implement and operate a system	S4
architecture concepts	S4
design patterns	A1
german	S1
english	L1
digital agency	A1
software development / engineering	S4
user experience	A1
javascript	L1
angular	A1
reactjs	A1
vue.js	S4
typescript	A1
digital agency	A1
software development / engineering	S4
user experience	A1
javascript	L1
angular	A1
reactjs	A1
vue.js	S4
typescript	A1
develop attractive state-of-the-art user interfaces	A1
application architecture	A1
api design	A1
implementation of functionality	A1
code reviews	S4
technical advice for our customers	S4
guidance and support for your teammates	S4
realize exciting projects	S4
degree in computer science	S1
javascript/typescript	A1
angular	A1
react	A1
vue	S4
architecture of complex single page applications	A1
accessibility	A1
usability	A1
current web standards	A1
code quality	A1
clean code	A1
quality and responsibility	A1
eye for aesthetics design	A1
faithful implementation	A1
german	S1
english	L1
financial services	K01
financial technology	A1
regulatory reporting	S4
c#	S1
typescript	A1
.net-core	K01
less	S1
sql-server	A1
financial services	K01
financial technology	A1
regulatory reporting	S4
c#	S1
typescript	A1
.net-core	K01
less	S1
sql-server	A1
deliver software solutions	A1
creation of programs	S4
configuration/customisation of platforms	S4
capture & analysis of requirements	A1
requirements capture/analysis and documentation	A1
design ( and documenting ) of own solutions	S4
writing software	S4
configuring software platforms	S4
troubleshooting	A1
debugging code	A1
testing	S4
analysis of test results	A1
documentation	A1
microsoft	K01
web development	S1
c#	S1
.net core	A1
.net framework	K01
sql	A1
sql server	A1
typescript	A1
javascript	L1
asp.net	K01
Blazor	A1
javascript	L1
JQuery	A1
angular	A1
react	A1
vue	S4
html5	A1
css ( less	S1
Bootstrap	A1
troubleshooting it infrastructure related issues	A1
microsoft-based development environment	A1
microsoft certifications	A1
team player	A1
methodical and reliable approach	A1
problem solving	A1
financial services	K01
communication skills	S1
java	S1
testing	S4
web-services	S1
java	S1
testing	S4
web-services	S1
solving business problems	S1
innovation & engineering practices	S1
apply your depth of knowledge and expertise	A1
software development lifecycle	A1
partner continuously with your many stakeholders	A1
stay focused on common goals	A1
creating api services	S4
work closely with colleagues and the business	S1
functional and non-functional requirements	S4
drive the design and implementation of well tested easily supportable scalable and robust solutions	S4
bs/ba degree	S1
deployment approaches	K09
considerations	A1
managing deployments	S4
industry wide technology strategies	S4
best practices	S4
work in large collaborative teams	S1
achieve organizational goals	A1
building an innovative culture	S1
java ( version 8 or higher	A1
spring boot	S4
performance testing	S4
unit testing	S4
integration testing	S4
behavioural testing frameworks	A1
mocking frameworks	A1
continuous integration	A1
designing applications	S4
high throughput mission critical high performance stp platforms	S1
designing and building reusable services	S4
support the developers in your team	S4
leading	S1
supporting	S4
coaching	S4
application delivery	A1
stakeholder management	A1
oracle	A1
cloud services	S1
information technology	A1
technology consulting	S4
.net	A1
microsoft-dynamics	A1
dynamics-365	A1
cloud services	S1
information technology	A1
technology consulting	S4
.net	A1
microsoft-dynamics	A1
dynamics-365	A1
developing	S4
development	S1
customisation	S3
configuration	A1
development of plug-ins	A1
c#	S1
work with business product owners and business analysts	S4
elicit requirements	A1
assist in developing design specifications	S4
maximise the benefit	S4
collaborate with other stakeholders/ end users	A1
software development lifecycle	A1
design	K02
development	S1
delivery	A1
dynamics 365	A1
dynamics crm	A1
dynamics 365	A1
.net	A1
ms dynamics 365	A1
technical aptitude	A1
providing extraordinary customer service influence impact	S4
problem-solving	A1
building customer and partner relationships	S4
microsoft stack	A1
dynamics 365	A1
scrum/agile	S1
sc clearance eligible	A1
.net webapi	K01
sharepoint	A1
vehicle tracking	S4
azure	A1
.net	A1
c#	S1
azure-cosmosdb	S4
rest	K02
vehicle tracking	S4
azure	A1
.net	A1
c#	S1
azure-cosmosdb	S4
rest	K02
development cycle	A1
analyzing	A1
deciding the best approach	A1
write code	A1
design patterns	A1
unit tests	S1
design	K02
write code	A1
.net	A1
modify .net services and apis	S4
apis	A1
maintain strong backend code quality	A1
c#	S1
.net framework	K01
.net core	A1
t-sql ( ms sql server	A1
object-oriented design	S1
restful services	A1
azure storage	A1
azure eventhub	S4
azure functions	A1
azure data lake	A1
azure cosmosdb	A1
security principles	A1
computer science	S1
engineering	S4
teamwork	A1
attention to detail	A1
resourceful	A1
problem solving	A1
communication skills	S1
english	L1
qa	S3
automation	S3
testing	S4
qa	S3
automation	S3
testing	S4
delivering real quality	S4
planning test activities for each build cycle	S4
testing client configurations	S4
reporting the results	S4
incorporating that testing into automation	S4
reporting and documenting issues found	S4
following up on issues raised	S4
communicator	A1
connect together complex issues	A1
appreciate quality	A1
testing	S4
automation	S3
complex system	A1
code	S1
financial services	K01
qa	S3
python	A1
automation	S3
financial services	K01
qa	S3
python	A1
automation	S3
automation	S3
functional testing	S4
regression/reconciliation	A1
new feature testing	S4
continuous delivery	A1
end to end automated testing	A1
data integrity	S1
performance	S1
presentation quality	A1
software development	A1
automate end to end test requirements	A1
java/python	A1
schedule and execute regression cycles	S1
execution of non-functional regression testing	S1
ensure the resiliency and performance of the system	A1
operational processes	S4
provide solutions	A1
improve operational efficiency	A1
agile	A1
participating in sprint planning backlog refinement	A1
retrospectives	S4
defect management	A1
of test coverage	A1
identify gaps	A1
provide improvements	A1
it/quality assurance	A1
bachelor's degree	S4
computer science	S1
quality assurance	S4
testing arena	S4
quality assurance methods/processes	A1
lifecycle principles	A1
quality assurance processes	S4
automated testing	S4
java	S1
python	A1
testing of mainframe	S4
test automation frameworks	A1
communicate	S1
work under pressure	A1
resolve issues affecting the production services	S3
detail oriented	A1
work independently	A1
core java	A1
unix scripting	A1
sql	A1
continuous integration ( ci	A1
git	S1
jenkins	S1
mainframe/ibm iseries	A1
iseries menu/end of day	S4
read/publish on message	S4
financial services	K01
cloud	A1
java	S1
amazon-web-services	S1
financial services	K01
cloud	A1
java	S1
amazon-web-services	S1
solving business problems	S1
innovation and engineering practices	S4
apply your depth of knowledge and expertise	A1
software development lifecycle	A1
partner continuously with your many stakeholders	A1
stay focused on common goals	A1
bs/ba degree	S1
core java	A1
spring boot	S4
Microservices	S1
AWS	S1
Kubernetes	S4
Docker	A1
Spinnaker	A1
devops	A1
ci/cd automation	S3
application data and infrastructure architecture disciplines	A1
industry-wide technology trends and best practices	S1
work in large collaborative teams	S1
achieve organizational goals	A1
building an innovative culture	S1
business analysis	A1
development	S1
maintenance	A1
software improvement	S1
artificial intelligence	A1
machine learning	S1
translation	S1
node.js	S4
javascript	L1
nestjs	A1
artificial intelligence	A1
machine learning	S1
translation	S1
node.js	S4
javascript	L1
nestjs	A1
design and develop a micro-service architecture	S4
gather understand and prioritize requirements	S3
research potential solutions	S1
rapidly build prototypes	A1
distill and communicate what was learned expected risks necessary resources	A1
security concerns	S4
provide high-level technical design	A1
strategy roadmap development	A1
technical architecture	A1
assure that our architectures are consistent	S4
industry best practices	A1
scalability	A1
availability	A1
maintainability	S3
flexibility	A1
communicate strategies and processes	S1
select the best talent to join	A1
onboard new colleagues	S4
javascript	L1
typescript	A1
node.js	S4
NestJS	A1
writing highly tested software	S4
unit testing	S4
integration	S1
defining and modelling a consumable api	A1
work autonomously	A1
energized by missions and goals	S4
designing	S4
analyzing	A1
optimising code	A1
troubleshooting large-scale distributed systems	A1
python	A1
django	A1
docker	A1
orm	S1
sqlalchemy	A1
python	A1
django	A1
docker	A1
orm	S1
sqlalchemy	A1
lead the design & implementation	A1
back-end services	K01
drive the implementation of new forecasting algorithms and tooling	S4
responsibility for live productions systems	A1
perform developer tests	S4
peer code reviews	S1
prepare strong documentation	S4
develop tools	S1
improve and maintain components & systems	A1
python	A1
back-end programming	A1
database structures	S4
webapp design	S4
python	A1
orms	S4
Django	A1
ORM	S1
SQLAlchemy	A1
designing & implementing distributed system architectures and apis	S4
docker	A1
deploy your applications	S4
computer engineering	A1
manage individual priorities deadlines and deliverables	A1
contribute to engineering efforts	S4
solve complex engineering problems	A1
get-things-done attitude	S4
identify shortcomings quickly	S4
statistical modeling	S1
optimization problems	A1
work with many different stakeholders	A1
english	L1
eu/efta or swiss work permit	S1
information technology	A1
online travel	S4
java	S1
web-services	S1
python	A1
distributed-system	A1
amazon-web-services	S1
information technology	A1
online travel	S4
java	S1
web-services	S1
python	A1
distributed-system	A1
amazon-web-services	S1
java	S1
python	A1
Docker	A1
AWS	S1
hadoop/spark	A1
sql	A1
airflow	A1
Jupyter	A1
agile/lean	S1
base your decisions on solid data and metrics	A1
produce outstanding work	S4
break challenges into bite-size tasks	S4
mentor team mates	S1
demand quality	A1
machine learning	S1
cloud services	S1
apis	A1
developing a whole range of key product features	S4
defining and implementing services	S4
collaborate with product engineers	A1
accountable for your own projects	S4
trusted to deliver	A1
form part of a broader team	S4
takes collective responsibility	A1
making success happen	S4
mobile application	A1
android	K02
mobile	S1
kotlin	A1
architect	A1
build	A1
maintain	A1
tackle challenges	A1
find creative ways to implement new features	S4
Kotlin	A1
RxJava	A1
Couroutines	A1
share your knowledge	A1
keep up the high level of quality	A1
reviews	S4
pairing	S4
mentoring	S4
focus on a top-notch user experience	S4
make the app context aware	A1
google awareness api	S1
improve of our sync framework	A1
build features	A1
location based services	S1
design	K02
ui	A1
ux	A1
mobile technologies	A1
mobile wallets	A1
android sdk	S1
coding	S4
Kotlin	A1
solving technical challenges	A1
ios app	A1
backend development	A1
degree	K09
computer science	S1
android	K02
payment	A1
loyalty	A1
shopping	K02
eCommerce	S1
internet marketing	S4
java	S1
spring	S1
node.js	S4
reactjs	A1
high-quality well-tested and scalable code	A1
ensure code quality and maintainability	A1
evolving architecture and tech stack	A1
code reviews	S4
refactoring	S4
standards	S4
improving build and test systems	S4
coach guide and mentor teams	S4
architecture	A1
technology	A1
collaborate	A1
identifying managing and minimizing technical debt	A1
share architecture knowledge findings and standard methodologies	A1
java	S1
spring framework	A1
web technologies	K01
( non- ) relational databases	S1
node.js	S4
react	A1
design implementation and operation of distributed services and apis	S4
strategic thinker	S1
analytical	A1
critical thinking	S1
frame problems	A1
drive teams	S4
collect data	S1
guide the analysis	A1
present the data	A1
influence leadership	S1
agile software development	S1
product discovery	A1
continuous deployment	A1
aspiration for quality	A1
sense of pragmatism	A1
quality assurance	S4
quick adoption of new technologies	A1
speak at conferences	S4
engage in the community	S4
english	L1
communication	S1
