questioning	A1
expressing self clearly and	A1
seek develop and secure new opportunities	S1
measure monitor and review performance of key accounts	S1
ensuring budgets and forecasts are met	S1
identify and monitor key performance and financial indicators	S1
maintain and monitor service expectations of existing and key accounts	S1
support external sales force	S1
management of business	S1
select appropriate carrier	A1
maximise freight profits	S1
manage your own time	A1
integrate and co-ordinate new business	A1
arrange regular meetings	S1
submit financial reports	S1
CIMA	A1
care deeply	A1
ever-changing environment	A1
excel	A1
shape the world of iot	A1
advocate quality	S1
verify	A1
validate	A1
analyze	A1
lower risks	A1
automate tests	S1
build great products	S1
shape the features	A1
cloud-based microservices	S1
audio/video pipelines	A1
machine learning	A1
mobile applications	S1
critical thinker	A1
user experience	A1
quality	S1
software testing	S1
curiosity	A1
resourcefulness	A1
find problems	A1
provide creative solutions	S1
software testing techniques	S1
advocate for quality in decision making	A1
tinkerer	A1
create your own apps and robots	A1
working closely with developers	A1
diligent with documenting your test plans test cases bug reports	S1
coding	A1
python	A1
java	A1
javascript	A1
Golang	A1
selenium	A1
TestCafe	A1
web	A1
api	A1
backend	A1
integration	A1
performance/load/stress	S1
security testing	S1
continuous integration	A1
continuous delivery and/or deployment	A1
jenkins	A1
CircleCI	A1
linux	A1
Docker	S1
Kubernetes	A1
web services	A1
networking	A1
distributed systems	A1
cloud services	A1
GraphQL	A1
driving?	A1
fast-paced team environment?	S1
upholding a positive brand image	S1
providing excellent customer service	S1
managing cash and card transactions	A1
delivering products safely and securely	A1
avoiding unnecessary risks	S1
safety and security procedures	S1
uk or eu driving license	A1
own car	A1
local area	S1
fast-paced environment	A1
customer service	S1
quality	S1
driving!	A1
food hygiene	A1
store cleanliness	S1
keen eye for detail	A1
day to day running of kitchen ordering and installs	A1
work closely with our installation team	S1
deliver projects efficiently	A1
maintain an impeccable level of customer service	S1
joinery	A1
kitchen industry!	S1
email	A1
organisational skills	A1
self-motivated	A1
working on their own initiative	A1
communicator	A1
kitchen industry	S1
computers	A1
attention to detail	A1
building and maintaining strong relationships	S1
multi-task	A1
deliver against deadlines	S1
valid uk driving license	A1
communication skills	S1
kitchen industry	S1
valid uk driving licence	S1
a-level	S1
support the bakery management team	S1
support the teams	S1
go above and beyond for our customers	A1
positive	A1
energetic	A1
engaging with people	S1
communications skills	S1
talented	A1
fun	A1
ambitious	A1
provide first line support to our team of colleagues	S1
reporting directly to the head of team experience	S1
overseeing hr administration	S1
maintaining hr records	A1
compiling hr data	A1
running reports	A1
managing hr processes	S1
hr best practices	S1
processes	A1
policies	S1
employment law	S1
organisation	A1
attention to detail	A1
positive	A1
professional	A1
communication	A1
literacy	A1
numeracy	S1
it skills	A1
willingness to develop	A1
line management	A1
level 5 cipd	S1
Kronos	A1
maximising sales	A1
building a highly engaged and high performing team	S1
leading from the front	A1
hands-on approach	A1
inspire your team	A1
inject fun into the work place	S1
create a truly amazing place to work	S1
delivers an exceptional standard of customer service	S1
pet knowledge	S1
deliver the highest standards of pet care	S1
ensure that the welfare of pets is a top priority	S1
promoting responsible pet ownership	A1
motivating training and developing your team	A1
running a store	A1
achieving and exceeding key store targets	S1
communicate effectively to your team	S1
take full responsibility for the store	S1
involved in absolutely everything in your store	A1
recruitment	A1
stock control	A1
store standards	S1
retail	A1
pets!	S1
supervisory/management	A1
hands-on approach	A1
delivering high standards!	A1
people person	A1
team player	A1
communication	A1
engage and inspire a team	A1
proactive	A1
customer focused	A1
recording of events and service failures	S1
chasing and completion of calls	S1
production of work request failures	S1
liaising with internal team and external contractors	S1
maintenance of records of live and paid works	S1
kpi's	S1
SLA's	A1
raising purchase orders	A1
completion of worksheet upload spreadsheet	A1
cafm system administration	S1
assisting the helpdesk manager	S1
general office administration duties	S1
reporting	A1
provide minutes of meetings	S1
contract administration	A1
ensure the helpdesk operates professionally	S1
manage the lines of communication	A1
achieve a high degree of customer and supplier satisfaction	S1
achieving key performance indicators ( kpis	S1
customer service	S1
system knowledge	S1
operate a helpdesk function across multiple sites	S1
accurately record details of the caller problem and severity	A1
ensure that the service centre manager is aware of situations which could develop into issues	S1
work within and to processes and procedures	S1
respond quickly and efficiently to all requests	A1
attention to detail	A1
obtaining and inputting information	S1
clear and professional telephone manner	S1
achieve a high degree of customer and supplier satisfaction	S1
applying logic and common sense	S1
ensuring that identified criteria are escalated	S1
scheduling ppm remedial and reactive work	A1
jeopardy management	A1
escalation of planned and responsive works	S1
monitor and optimise the utilisation of engineer activities	S1
scheduling of works	S1
raising purchase orders	A1
run reports	A1
show outstanding work orders	S1
attend training and coaching sessions	S1
identify any potential areas of improvement	A1
flexible	A1
adaptable	A1
highlight any training needs and development	A1
operating a facilities management helpdesk	S1
call centre service	S1
developing productive working relationships	S1
qfm helpdesk system	A1
computer hardware	A1
peripherals	A1
applications	S1
networks	A1
shared files and folders	S1
report creation	S1
keyboard skills	S1
focusing on client & customer	A1
delivering stretched results	S1
act collaboratively	S1
intellectual agility	A1
willingness to learn	A1
computer databases	A1
nvq level 2 or 3	A1
customer service	S1
call handling	A1
working with and developing kpi’s and measurement information	S1
rsa level i keyboard skills	A1
european computer driving licence ( ecdl ) level i	A1
microsoft word	A1
microsoft excel	A1
level 2 & 3 nursery	S1
providing care and educational support	S1
pms	A1
reservation systems	S1
customer service?	S1
organised analytical approach	A1
numerical skills	S1
pms	A1
reservation systems	S1
timekeeping	A1
work calmly in a high-pressure environment	S1
english	A1
making reservations	A1
ensuring that all enquiries receive a prompt response	A1
all correspondence is accurately filed	A1
log failures	S1
convert a booking	A1
monitor non-arrivals and late cancellations	S1
run daily arrival checks	S1
ensure all reservations are correct	S1
work with others	A1
improve our customer service	S1
cover reception	A1
monitoring and recording key data	S1
keeping the pms up-to-date	A1
ensure that market segmentation rates and guest information are accurately recorded	A1
helping the hotel to achieve its financial targets	S1
upsell	A1
escalate/communicate about any new sales leads	S1
contribute to pricing decisions	A1
highlighting if availability is changing	S1
rate strategies should be reviewed	S1
pms	A1
reservation systems	S1
organised	A1
analytical	A1
customer service	S1
commercial awareness	A1
corporate tax	A1
personal tax	A1
vat	A1
ACCA/ACA/ATT	S1
cta	A1
supporting and training the more junior member of staff	S1
manging	A1
supervising	A1
coaching	A1
mentoring	A1
work with a varied portfolio	S1
provide compliance and advisory services	S1
support clients	S1
services in corporation tax and personal tax	S1
work in a varied capacity	S1
confident	A1
professional	A1
ambitious	A1
tax planning	A1
advisory work	A1
tax computations and reviews	S1
capital gains tax	A1
trusts	A1
inheritance tax/wills	A1
property tax	A1
corporate tax planning	A1
mergers & acquisitions	A1
restructuring	A1
investments	A1
dealing with a variety of high net worth individuals partnerships directors tax omb	S1
manage the team	A1
planning and reviewing work in progress	S1
supporting the directors	A1
providing direction to the team	S1
lead and grow the department	A1
business development	A1
selling services	S1
CIMA	A1
help residents enjoy each day	A1
assist with daily living	A1
providing support and companionship	A1
dedication	A1
compassion	A1
supporting residents with their food and drink	S1
following care plans	S1
caring for older people	A1
can-do approach	S1
communication skills	S1
empathy	A1
warm-hearted approach	A1
compassion	A1
deliver the highest standard of care and support	S1
drive expansion	A1
exceed monthly / quarterly sales targets	S1
driving new opportunities	A1
exceed monthly / quarterly sales targets	S1
driving new opportunities	A1
analyse your industry territory	S1
identify prioritise and segment accounts	A1
collaborating	A1
create demand	A1
cold calling	A1
email / social campaigns	S1
supporting other business development activities	S1
engage your extended team	S1
engage with prospect organisations	S1
strategic value-based selling	A1
business case definition	A1
return on investment analysis	S1
references	A1
analyst data	A1
engage with customer cios and cfos	S1
converse with senior technologists	A1
generate short term results	S1
maintaining a long term perspective	A1
maximize overall revenue generation	A1
provide accurate monthly forecasting and revenue delivery	A1
build and maintain a territory pipeline of business	S1
selling enterprise software	S1
PaaS	A1
IaaS	A1
saas	A1
net direct new business sales	A1
consistent delivery against targets	S1
strong customer care	S1
helping to ensure customer success	S1
credibility	S1
building strong relationships internally and with the customer	S1
selling industry-specific use cases / technologies	S1
CPG	A1
manufacturing	A1
services	A1
iPaaS	A1
api management	A1
automation	A1
bpm	A1
deliver key business outcomes	A1
bachelor’s degree	A1
full driving license	A1
internal framing work	S1
finishing work	A1
skirtings	A1
facings	A1
cscs card	S1
carpentry	A1
CSCS	A1
electro/mechanical assembly	A1
hand assembly	A1
wiring electronic sub-assemblies	A1
mechanical assembly	A1
working to customer specifications	S1
can do attitude	S1
driving	A1
strategic planning & governance	S1
strategic planning	A1
performance reporting	A1
strategic planning	A1
corporate performance	A1
manage the strategic planning and corporate performance reporting functions	A1
manage the strategic and operational planning process	S1
support senior colleagues	A1
completing plans	A1
provide specialist advice	S1
guidance	A1
support to managers staff and the public	S1
strategic planning	A1
corporate performance	A1
conduct stakeholder consultation/engagement	S1
engage with internal and external groups and networks	A1
development or expansion of good practice	S1
strategic planning	A1
corporate performance	A1
coordinate the preparation of an annual report	A1
ensure the annual report complies with the government financial reporting manual ( frem	S1
government financial reporting manual ( frem	A1
analytical decision making	A1
communication skills	S1
maintain positive relationships	S1
seek information and co-operation	A1
conduct trend analysis on complex data sets	S1
working with stakeholders	S1
inform of any discrepancies variances and trends	A1
scqf level 9	A1
technology	A1
project manage	A1
bridge the gap	A1
liaising with many stake holders	S1
influencing and negotiation skills	S1
prince2 practitioner qualification	S1
msp qualification	S1
project management	A1
change management	A1
benefit realisation	A1
workforce redesign	A1
energetic	A1
work independently as well as in a team	A1
persistent	A1
sales	A1
B2B	A1
concept sales	A1
business	A1
english	A1
french	A1
german	A1
java	A1
working in the web layer	S1
working as a key member of an agile team	A1
frequent delivery	A1
end-to-end application ownership	S1
contributing to a cross functional agile team	A1
elaboration development and testing of user stories	S1
sprint planning	A1
backlog grooming	A1
task estimation	A1
development and modification of frameworks common components and business components	S1
development of unit tests	S1
contribution to the creation of automation in higher levels of the test pyramid	S1
refactoring code	S1
contribution to code quality improvements	S1
development standards	S1
best practices	S1
software development	A1
review of colleagues code	S1
progressive development behaviours	A1
maximizing collaboration	S1
knowledge sharing	S1
effective pairing	A1
creation of pocs / spike development	A1
involvement in technology evaluation	S1
work and communicate across geographical and cultural borders	A1
build a strong professional network	S1
participation in the elaboration of user stories	S1
agree stories are sufficiently described	S1
quality design and implementation	S1
ensuring builds are kept green	A1
code management strategy ( branching ) is closely	A1
raising capability and standards	S1
pairing on tasks	A1
peer review of team members code	S1
constructive feedback for improvement	A1
proactive contribution to continual improvements	A1
active participation in retrospectives	A1
engagement with cross team bestpractice	S1
support product owner	S1
identify and manage risks debt issues and opportunities	S1
support the recruitment activities	S1
technical support	A1
technical support	A1
implementation skills	A1
java	A1
SpringBoot	A1
unit testing	S1
development	A1
agile	A1
integration of testing into development workflow	S1
test frameworks build tooling	S1
maven)	A1
work in ui	A1
continual delivery pipeline tools	S1
jenkins	A1
ansible	A1
communication skills	S1
articulate clearly to technical team members	S1
work with product owners	S1
collaborative	A1
critical reasoning	A1
problem solving	A1
agile software development	A1
xp	A1
BDD	A1
TDD	A1
fast turnaround development	A1
continuous delivery	A1
service orientated	A1
microservice architecture	A1
shared-nothing architecture	S1
domain driven design	A1
bounded context	A1
high volume transactional systems	A1
api gateway	S1
Akana	A1
coherent software architecture and design	S1
message or event based architectures	S1
eventual consistency concepts	S1
contributor to open source projects	S1
mechanical understanding	A1
automation	A1
process optimization	A1
support and problem-solving	A1
decanters	A1
high-speed separators	A1
putting put the customer first	A1
preventive maintenance of supplied equipment and machines	S1
repair and service according to customer requirements	S1
support to customers	S1
general technical support	A1
adjustments to equipment and machines	A1
start-up and commissioning of machinery	S1
process plants on board vessels	A1
training of the crew	S1
optimization of plant and equipment	A1
decanters	A1
high-speed separators	A1
PureBilge	A1
FWG	A1
pure	A1
marine business	A1
sailing	A1
mechanical understanding	A1
automation	A1
control systems	A1
microsoft office	A1
danish	A1
english	A1
developing our new data backbone	A1
inspiring the stakeholders	A1
advanced analytics	A1
artificial intelligence	S1
extracting insights and value from data	A1
applying domain expertise	A1
ensure data collection procedures	S1
building analytic systems	A1
operationalise data mining and analysis into business applications	S1
maintain the productionised models	S1
quantitative or data-heavy functions	A1
c#	A1
python	A1
java	A1
open source data ingestion tools	S1
nifi	A1
cloud platforms	A1
container technology tools	S1
analytics engines	A1
spark	A1
Databricks	A1
data visualisation tools	S1
cloud platforms	A1
machine learning	A1
algorithms	A1
willingness to learn	A1
criminal record certificate	S1
criminal record certificate	S1
criminal record certificate	S1
registering and controlling goods	A1
picking and packing	A1
preparing pallets	S1
loading and unloading lorries	A1
operating a forklift	A1
forklift license	A1
independently	A1
proactively	A1
set high standards	S1
flexible	A1
helpful	A1
developing and applying new optical microscopy techniques	S1
intestine	A1
biopharmaceuticals	A1
reinvent our research strategies	S1
constructing a 'light sheet' fluorescence microscope	A1
live-sample imaging	A1
3d printed organoids	A1
pursue a deeper understanding	S1
implementing one of the worlds most advanced optical microscopes	S1
use the microscope	A1
capture how fluorescently labelled biopharmaceuticals travel through the intestinal barrier	A1
optimizing microscope hardware and software	S1
provide the best images	S1
drive hardware/software development	A1
document present and publish scientific findings	S1
contribute to the enjoyable and collaborative work environment	S1
master's degree	S1
work independently	A1
prioritize tasks	S1
plan and execute complex hardware implementation	A1
interface optics	A1
electronics	A1
software	A1
work constructively in a team	A1
analyse	A1
contribute	A1
solve biological/mathematical challenges	S1
use software for instrument control	A1
labview	A1
use software for data simulation	S1
basic image analysis	S1
matlab	A1
use software for basic mechanical design	A1
SOLIDWORKS	A1
communicate professionally	S1
english	A1
present insights progress and bottlenecks	S1
european code of conduct for research integrity	S1
software/hardware development	A1
fundamental biology/physiology	S1
bsc/msc diploma	S1
research	A1
teaching	A1
marketingin	A1
business	A1
development	A1
active engagement	A1
strengthen the relationship	S1
initiate and participate in external funding	A1
sustained record of research publications	S1
research management	A1
teaching	A1
provide dynamic leadership	S1
teaching	A1
research dissemination	A1
working with business and society	S1
undertaking research	A1
teaching practice	S1
dissemination	A1
business research	A1
research management	A1
initiation of research projects	S1
supervision of ph.d	S1
international research co-operation	A1
journal editorship	S1
reviewing for academic journals	S1
academic development	A1
marketing	A1
research-based teaching	S1
supervision	A1
examination	A1
teaching on business research	A1
course and program development	S1
promotion	A1
participation in and possibly initiation of externally funded research projects	S1
contribution to the administrative responsibilities	S1
dissemination of research findings	S1
participation in the departments regular research activities	S1
engagement in and contribution to academic citizenship activities	S1
participate actively in the research and teaching activities	S1
maintain and establish broad links	A1
record of research	A1
teaching	A1
research management	A1
research	A1
teaching	A1
business research	A1
provide dynamic leadership	S1
development of research	A1
teaching	A1
research dissemination	A1
working with business and society	S1
achieving ) research grants	S1
pedagogical qualifications	S1
development and innovation in the pedagogical area	S1
english	A1
teaching qualifications	S1
teaching evaluations	S1
love being outdoors	A1
create an entertaining & memorable tour	S1
share your knowledge?	A1
responsible and professional work ethic?	S1
providing fun informative and engaging tours	S1
know all information provided	A1
run tours on time	S1
provide extensive information about the city	S1
answering customer questions	S1
show independent thinking	A1
professonal approach	A1
leadership	S1
assiting with teambuilding excercises	A1
leading	A1
meticulous	A1
detail-oriented	A1
ensure the shop is tidy and clean	A1
dusting	A1
vacuuming	A1
set up for your customers	A1
independent work approach	A1
street-marketing	S1
street-marketing	S1
approaching people	S1
confident	A1
engaging	A1
english	A1
german	A1
danish	A1
lively	A1
fun	A1
public speaking	A1
engage an audience	S1
responsible	A1
dutiful	A1
mature	A1
demonstrate leadership abilities	S1
service-minded	A1
providing a first-class experience	S1
perform at your best ability	A1
high-school diploma	S1
bachelor/post-graduate degree	S1
danish	A1
english	A1
service-industry	S1
tourism	A1
social media marketing	S1
sales	A1
Segways	A1
first-aid skills	S1
stamina	A1
love for being outdoors	A1
supply chain	S1
manage challenges	S1
business acumen	A1
planning skills	A1
collaborating	A1
ensure reliable supply	S1
operating in a structured formal monthly sales and operations planning process	S1
sales and operations planning process	S1
maximize product availability	S1
standardized global processes	A1
sap	A1
optimize supply and inventory plans	S1
lead supply scenario analysis	S1
monitor supply and capacity performance	S1
coordinate supply and capacity bottleneck management	A1
support the supply risk management process	S1
respond to ad hoc requests	S1
establish and develop a close collaboration	S1
planning	A1
masters degree	S1
business	A1
engineering	A1
supply chain management	A1
supply chain	S1
sap apo	A1
providing ideas and input for optimization	A1
handle hands-on planning tasks	S1
complex coordination	A1
overview	A1
sense of detail	A1
open-minded	A1
establish collaborative relations to people	S1
tailor your communication to your audience	A1
make people prioritize your agenda	A1
advanced electron microscopy	A1
environmental catalysis	S1
nanomaterials	A1
selective catalytic reduction ( scr ) of nox	A1
undertake atomic-scale studies	S1
situ transmission electron microscopy	A1
characterization tools	S1
surface science techniques	A1
catalyst testing	A1
synthesis	A1
develop an understanding of the catalytic performances	S1
target new designs of catalyst materials	S1
improving nox emission control	A1
experimental research	A1
scr catalysts	A1
application of s/tem and eels for atomic-resolution and in situ studies	S1
develop our atomic-scale model	A1
scr	A1
scr catalysis	S1
publishing in high-profile journals	S1
committed	A1
flexible	A1
innovative mind-set	A1
new ideas	S1
ready to face new challenges	S1
take responsibility	S1
execute and communicate complex research goals	S1
enthusiastic	A1
catalysis sciences	S1
Ph.D	S1
physics	A1
chemistry	A1
high-resolution ( scanning ) transmission electron microscopy ( s/tem	S1
heterogeneous catalysts	A1
solid-state nanomaterials	A1
audio engineering	A1
acoustic design	A1
algorithm trimming	A1
sound quality evaluation	S1
passion	A1
creativity	A1
work on new algorithm concepts	S1
directionality/beam-forming	S1
trimming and verification of various audio algorithms	S1
audio engineering	A1
msc	A1
outgoing	A1
getting things to move forward	A1
inspires your colleagues	A1
dealing with many stakeholders	A1
setting a direction	A1
english	A1
audio engineering	A1
algorithm concepting	A1
directionality	A1
beam-forming	A1
matlab	A1
python	A1
trimming of various audio algorithms	A1
noise reduction systems	S1
eq	A1
compressors	A1
objective and subjective sound quality evaluation	S1
measurement systems for audio evaluation	S1
soundcheck	A1
head acoustics acqua audio analyzers	S1
communicating technical issues	S1
research the market	A1
take initial contact to potential clients	S1
carry out market research of potential clients	S1
establish initial contact to potential clients	S1
translate sales material	S1
english	A1
italian	A1
italian	A1
english	A1
tele marketing	A1
proactive on the phone	A1
independent	A1
positive	A1
proactive	A1
danish	A1
working in a sales department	A1
leading technology strategy roadmaps and transformation plans	A1
communication	A1
integration	A1
PLM/PDM	S1
manufacturing execution	A1
product quality systems ( qsys	S1
global erp ( sap ) platforms	S1
dynamic	A1
personal motivation	A1
drive	A1
approach complex tasks	S1
open mind	A1
focus	A1
providing the best solution	S1
structured	A1
analytic	A1
lead the technology roadmap	A1
participate actively in strategic projects	S1
PLM	A1
main interface between plm data and systems governance organizations	S1
lead and coach a team	A1
PLM	A1
model and control enterprise plm architecture ( data and systems	A1
TOGAF	A1
asses value propositions of project proposals	S1
Teamcenter	A1
PLM	A1
how systems interact with erp	S1
manufacturing execution systems	S1
PLM	A1
erp systems	A1
capturing requirements from large organizations	S1
architecting value creating solutions for the business	A1
enabling the software to create value	S1
processes	A1
lifecycles	A1
wind turbine	A1
communicate on all levels	A1
persuasive communicator	S1
english	A1
teaching	A1
research	A1
basic and applied nutrition of ruminants	A1
dairy cattle	A1
dairy production	A1
data modelling	A1
evaluation of feed quality and feed intake in dairy cattle	S1
nordic feed evaluation system	S1
NorFor	A1
dairymanagement system	A1
feed evaluation	S1
digestive processes	S1
intermediary metabolism	A1
impact of nutrition and feeding management	S1
animal health	A1
product quality	S1
research	A1
publication/academic dissemination	S1
research-based teaching	S1
examination	A1
sharing knowledge with society	S1
phd degree	A1
research	A1
teaching	A1
enterprising	A1
interpersonal skills	S1
information technology	A1
java	A1
algorithm	A1
database	A1
multithreading	A1
concurrency	A1
solve technical challenges	S1
deliver high quality code	S1
build and ship new features	S1
write high quality testable and efficient code	S1
promote new ideas	S1
take active part in features discussions and roadmap prioritisation	S1
integrate cutting edge research and technologies	S1
work closely with our customers and other teams	A1
developing production level software	S1
designing multi-threaded systems and algorithms	A1
system design	A1
data structures	S1
algorithms	A1
java	A1
troubleshooting	A1
performance profiling	A1
optimisation	A1
development methodologies	S1
care about code quality	S1
communication skills	S1
sense of humor!	S1
eCommerce	A1
price comparison	A1
online portal	S1
.net	A1
agile	A1
rest	A1
microservices	A1
eCommerce	A1
price comparison	A1
online portal	S1
.net	A1
agile	A1
rest	A1
microservices	A1
development test and deployment of new components	S1
transition	A1
re-engineering	A1
design	A1
extension	A1
continuous integration	A1
continuous deployment	A1
.net	A1
micro services	A1
development and implementation of rest api's	S1
web and/or e-commerce	S1
agile method practice	S1
english	A1
german	A1
data science	A1
it security	A1
software development / engineering	S1
java	A1
rest	A1
cloud	A1
spring	A1
design-patterns	S1
data science	A1
it security	A1
software development / engineering	S1
java	A1
rest	A1
cloud	A1
spring	A1
design-patterns	S1
enthusiasm	A1
professional attitude	A1
work together closely with product owners and colleagues	A1
develop an in-depth understanding of the domains and the requirements	S1
happy to share your valuable insights	A1
offer them professional advice	S1
share your knowledge	S1
advise individual colleagues	A1
software development	A1
agile project team	S1
java stack frameworks	S1
quality	S1
testing at various levels in an agile environment	S1
test automation	A1
clear easy-to-maintain code	S1
latest technologies	S1
back end development	A1
databases	A1
cloud computing	A1
restful api	A1
big data	A1
devops	A1
build implement and operate a system	A1
architecture concepts	S1
design patterns	S1
german	A1
english	A1
digital agency	A1
software development / engineering	S1
user experience	A1
javascript	A1
angular	A1
reactjs	A1
vue.js	A1
typescript	A1
digital agency	A1
software development / engineering	S1
user experience	A1
javascript	A1
angular	A1
reactjs	A1
vue.js	A1
typescript	A1
develop attractive state-of-the-art user interfaces	S1
application architecture	S1
api design	A1
implementation of functionality	A1
code reviews	S1
technical advice for our customers	A1
guidance and support for your teammates	A1
realize exciting projects	S1
degree in computer science	S1
javascript/typescript	S1
angular	A1
react	A1
vue	A1
architecture of complex single page applications	S1
accessibility	S1
usability	A1
current web standards	A1
code quality	S1
clean code	A1
quality and responsibility	S1
eye for aesthetics design	A1
faithful implementation	A1
german	A1
english	A1
financial services	S1
financial technology	S1
regulatory reporting	S1
c#	A1
typescript	A1
.net-core	S1
less	A1
sql-server	S1
financial services	S1
financial technology	S1
regulatory reporting	S1
c#	A1
typescript	A1
.net-core	S1
less	A1
sql-server	S1
deliver software solutions	S1
creation of programs	S1
configuration/customisation of platforms	S1
capture & analysis of requirements	S1
requirements capture/analysis and documentation	S1
design ( and documenting ) of own solutions	S1
writing software	S1
configuring software platforms	S1
troubleshooting	A1
debugging code	S1
testing	A1
analysis of test results	S1
documentation	S1
microsoft	A1
web development	A1
c#	A1
.net core	S1
.net framework	A1
sql	A1
sql server	A1
typescript	A1
javascript	A1
asp.net	A1
Blazor	A1
javascript	A1
JQuery	A1
angular	A1
react	A1
vue	A1
html5	A1
css ( less	A1
Bootstrap	A1
troubleshooting it infrastructure related issues	S1
microsoft-based development environment	S1
microsoft certifications	S1
team player	A1
methodical and reliable approach	A1
problem solving	A1
financial services	S1
communication skills	S1
java	A1
testing	A1
web-services	S1
java	A1
testing	A1
web-services	S1
solving business problems	A1
innovation & engineering practices	S1
apply your depth of knowledge and expertise	S1
software development lifecycle	S1
partner continuously with your many stakeholders	S1
stay focused on common goals	S1
creating api services	S1
work closely with colleagues and the business	S1
functional and non-functional requirements	S1
drive the design and implementation of well tested easily supportable scalable and robust solutions	A1
bs/ba degree	A1
deployment approaches	S1
considerations	A1
managing deployments	A1
industry wide technology strategies	A1
best practices	S1
work in large collaborative teams	A1
achieve organizational goals	S1
building an innovative culture	A1
java ( version 8 or higher	S1
spring boot	A1
performance testing	S1
unit testing	S1
integration testing	S1
behavioural testing frameworks	S1
mocking frameworks	A1
continuous integration	A1
designing applications	S1
high throughput mission critical high performance stp platforms	A1
designing and building reusable services	S1
support the developers in your team	A1
leading	A1
supporting	A1
coaching	A1
application delivery	S1
stakeholder management	A1
oracle	A1
cloud services	A1
information technology	A1
technology consulting	A1
.net	A1
microsoft-dynamics	A1
dynamics-365	A1
cloud services	A1
information technology	A1
technology consulting	A1
.net	A1
microsoft-dynamics	A1
dynamics-365	A1
developing	A1
development	A1
customisation	A1
configuration	A1
development of plug-ins	A1
c#	A1
work with business product owners and business analysts	S1
elicit requirements	S1
assist in developing design specifications	S1
maximise the benefit	S1
collaborate with other stakeholders/ end users	S1
software development lifecycle	S1
design	A1
development	A1
delivery	A1
dynamics 365	A1
dynamics crm	A1
dynamics 365	A1
.net	A1
ms dynamics 365	A1
technical aptitude	S1
providing extraordinary customer service influence impact	S1
problem-solving	A1
building customer and partner relationships	S1
microsoft stack	A1
dynamics 365	A1
scrum/agile	A1
sc clearance eligible	A1
.net webapi	A1
sharepoint	S1
vehicle tracking	A1
azure	A1
.net	A1
c#	A1
azure-cosmosdb	S1
rest	A1
vehicle tracking	A1
azure	A1
.net	A1
c#	A1
azure-cosmosdb	S1
rest	A1
development cycle	A1
analyzing	A1
deciding the best approach	S1
write code	S1
design patterns	S1
unit tests	A1
design	A1
write code	S1
.net	A1
modify .net services and apis	S1
apis	A1
maintain strong backend code quality	S1
c#	A1
.net framework	A1
.net core	S1
t-sql ( ms sql server	S1
object-oriented design	A1
restful services	S1
azure storage	A1
azure eventhub	S1
azure functions	A1
azure data lake	S1
azure cosmosdb	A1
security principles	A1
computer science	A1
engineering	A1
teamwork	A1
attention to detail	A1
resourceful	A1
problem solving	A1
communication skills	S1
english	A1
qa	A1
automation	A1
testing	A1
qa	A1
automation	A1
testing	A1
delivering real quality	S1
planning test activities for each build cycle	S1
testing client configurations	S1
reporting the results	S1
incorporating that testing into automation	A1
reporting and documenting issues found	S1
following up on issues raised	S1
communicator	A1
connect together complex issues	S1
appreciate quality	S1
testing	A1
automation	A1
complex system	A1
code	A1
financial services	S1
qa	A1
python	A1
automation	A1
financial services	S1
qa	A1
python	A1
automation	A1
automation	A1
functional testing	S1
regression/reconciliation	A1
new feature testing	S1
continuous delivery	A1
end to end automated testing	S1
data integrity	A1
performance	A1
presentation quality	S1
software development	A1
automate end to end test requirements	S1
java/python	A1
schedule and execute regression cycles	S1
execution of non-functional regression testing	S1
ensure the resiliency and performance of the system	A1
operational processes	S1
provide solutions	S1
improve operational efficiency	A1
agile	A1
participating in sprint planning backlog refinement	A1
retrospectives	A1
defect management	A1
of test coverage	S1
identify gaps	S1
provide improvements	A1
it/quality assurance	S1
bachelor's degree	A1
computer science	A1
quality assurance	S1
testing arena	S1
quality assurance methods/processes	S1
lifecycle principles	S1
quality assurance processes	S1
automated testing	S1
java	A1
python	A1
testing of mainframe	A1
test automation frameworks	S1
communicate	A1
work under pressure	S1
resolve issues affecting the production services	S1
detail oriented	A1
work independently	A1
core java	A1
unix scripting	A1
sql	A1
continuous integration ( ci	S1
git	A1
jenkins	A1
mainframe/ibm iseries	A1
iseries menu/end of day	A1
read/publish on message	S1
financial services	S1
cloud	A1
java	A1
amazon-web-services	S1
financial services	S1
cloud	A1
java	A1
amazon-web-services	S1
solving business problems	A1
innovation and engineering practices	S1
apply your depth of knowledge and expertise	S1
software development lifecycle	S1
partner continuously with your many stakeholders	S1
stay focused on common goals	S1
bs/ba degree	A1
core java	A1
spring boot	A1
Microservices	A1
AWS	A1
Kubernetes	A1
Docker	S1
Spinnaker	A1
devops	A1
ci/cd automation	S1
application data and infrastructure architecture disciplines	A1
industry-wide technology trends and best practices	S1
work in large collaborative teams	A1
achieve organizational goals	S1
building an innovative culture	A1
business analysis	S1
development	A1
maintenance	A1
software improvement	A1
artificial intelligence	S1
machine learning	A1
translation	A1
node.js	A1
javascript	A1
nestjs	A1
artificial intelligence	S1
machine learning	A1
translation	A1
node.js	A1
javascript	A1
nestjs	A1
design and develop a micro-service architecture	S1
gather understand and prioritize requirements	S1
research potential solutions	S1
rapidly build prototypes	S1
distill and communicate what was learned expected risks necessary resources	S1
security concerns	S1
provide high-level technical design	S1
strategy roadmap development	A1
technical architecture	S1
assure that our architectures are consistent	A1
industry best practices	S1
scalability	A1
availability	S1
maintainability	S1
flexibility	A1
communicate strategies and processes	A1
select the best talent to join	S1
onboard new colleagues	A1
javascript	A1
typescript	A1
node.js	A1
NestJS	A1
writing highly tested software	S1
unit testing	S1
integration	A1
defining and modelling a consumable api	S1
work autonomously	A1
energized by missions and goals	S1
designing	A1
analyzing	A1
optimising code	A1
troubleshooting large-scale distributed systems	S1
python	A1
django	A1
docker	S1
orm	A1
sqlalchemy	A1
python	A1
django	A1
docker	S1
orm	A1
sqlalchemy	A1
lead the design & implementation	A1
back-end services	S1
drive the implementation of new forecasting algorithms and tooling	A1
responsibility for live productions systems	S1
perform developer tests	S1
peer code reviews	S1
prepare strong documentation	S1
develop tools	S1
improve and maintain components & systems	A1
python	A1
back-end programming	A1
database structures	S1
webapp design	S1
python	A1
orms	A1
Django	A1
ORM	A1
SQLAlchemy	A1
designing & implementing distributed system architectures and apis	S1
docker	S1
deploy your applications	S1
computer engineering	A1
manage individual priorities deadlines and deliverables	S1
contribute to engineering efforts	A1
solve complex engineering problems	A1
get-things-done attitude	S1
identify shortcomings quickly	S1
statistical modeling	S1
optimization problems	S1
work with many different stakeholders	A1
english	A1
eu/efta or swiss work permit	A1
information technology	A1
online travel	A1
java	A1
web-services	S1
python	A1
distributed-system	A1
amazon-web-services	S1
information technology	A1
online travel	A1
java	A1
web-services	S1
python	A1
distributed-system	A1
amazon-web-services	S1
java	A1
python	A1
Docker	S1
AWS	A1
hadoop/spark	A1
sql	A1
airflow	A1
Jupyter	A1
agile/lean	S1
base your decisions on solid data and metrics	S1
produce outstanding work	S1
break challenges into bite-size tasks	S1
mentor team mates	S1
demand quality	S1
machine learning	A1
cloud services	A1
apis	A1
developing a whole range of key product features	S1
defining and implementing services	S1
collaborate with product engineers	S1
accountable for your own projects	A1
trusted to deliver	A1
form part of a broader team	S1
takes collective responsibility	S1
making success happen	S1
mobile application	S1
android	A1
mobile	A1
kotlin	A1
architect	A1
build	A1
maintain	A1
tackle challenges	S1
find creative ways to implement new features	A1
Kotlin	A1
RxJava	A1
Couroutines	A1
share your knowledge	S1
keep up the high level of quality	S1
reviews	A1
pairing	A1
mentoring	A1
focus on a top-notch user experience	S1
make the app context aware	S1
google awareness api	S1
improve of our sync framework	A1
build features	S1
location based services	S1
design	A1
ui	A1
ux	A1
mobile technologies	S1
mobile wallets	A1
android sdk	A1
coding	A1
Kotlin	A1
solving technical challenges	S1
ios app	S1
backend development	A1
degree	A1
computer science	A1
android	A1
payment	A1
loyalty	A1
shopping	A1
eCommerce	A1
internet marketing	A1
java	A1
spring	A1
node.js	A1
reactjs	A1
high-quality well-tested and scalable code	S1
ensure code quality and maintainability	S1
evolving architecture and tech stack	S1
code reviews	S1
refactoring	A1
standards	A1
improving build and test systems	S1
coach guide and mentor teams	S1
architecture	A1
technology	A1
collaborate	A1
identifying managing and minimizing technical debt	S1
share architecture knowledge findings and standard methodologies	S1
java	A1
spring framework	A1
web technologies	S1
( non- ) relational databases	S1
node.js	A1
react	A1
design implementation and operation of distributed services and apis	S1
strategic thinker	S1
analytical	A1
critical thinking	A1
frame problems	S1
drive teams	A1
collect data	A1
guide the analysis	S1
present the data	A1
influence leadership	A1
agile software development	A1
product discovery	A1
continuous deployment	A1
aspiration for quality	S1
sense of pragmatism	A1
quality assurance	S1
quick adoption of new technologies	A1
speak at conferences	S1
engage in the community	S1
english	A1
communication	A1
